1111111111
100000B001
1P00B00C01
100000B001
1C0B0E0C01
1111111111
