1111111111
1000010001
1P00010C01
1000000001
1C010E0C01
1111111111
