1111111111
10P00C0001
1001000001
1000E00001
10100C0001
1111111111
