111111111111111
10000C0000000E1
100000000011111
100P00000000001
10000000000C001
100001111000001
1C0000000000C01
111111111111111
