111111111111111
1B000C000000BE1
100000000011111
100P00000000001
100000B0000C001
10B00111100B001
1C00000B0000C01
111111111111111
