111111111111111
11100000C00C001
100000000000101
100000P00000001
100000000000111
11111000000C001
100000000000001
10C0000000000C1
100000000000001
100001111000001
10000000000E001
1000000C0000001
1C0000000000001
111111111111111
