11111
1E001
100P1
1C001
11111
