11111
1E011
100P1
1C001
11110
