11111
10001
100P1
1C001
11111
