11111
1E001
100P1
10001
11111
