11111
1E001
10001
1C001
11111
