1111111
1P00001
1000C01
1E00R01
100C001
1111111
